Grapheme	IPA
$	NULL
u*/ai	u/w */ai
y*/a	y/ɥ */a
u*/ẽ	u/w ẽ
ɪĩ	ɪ/j ĩ
i*/a	i/j */a
i*/ẽ	i/j */ẽ
iuai	iu/ɥ ai
u*/ã	u/w */ã
u*/ɛ	u/w */ɛ
uø	u/w ø
i*/ɛ	i/j */ɛ
*/a	*/a
*/ai	*/ai
*/au	*/au
*/e	*/e
*/ei	*/ei
*/i	*/i
*/o	*/o
*/u	*/u
*/y	*/y
*/ã	*/ã
*/æ̃	*/æ̃
*/ĩ	*/ĩ
*/ɑ	*/ɑ
*/ɔ	*/ɔ
*/ə	*/ə
*/ə̃	*/ə̃
*/ɛ	*/ɛ
*/ɿ	*/ɿ
*/ʅ	*/ʅ
*/ẽ	*/ẽ
+	+
^	NULL
^dz	dz
^pf	pf
^pfʰ	pfʰ
^taĩã∼⁵⁵	t aĩã/ai ⁵⁵
^tʰh	tʰ
_	NULL
a	a
ae	ae
ai	ai
aiu	aiu/ai
aiã	aiã/ai
au	au
auə	auə/au
ay	ay
aæ̃	æ̃
aĩ	ai
aũ	au
aɔ	aɔ
aə	aə
b	b
d	d
dz	dz
dʑ	dʑ
e	e
ei	ei
eu	eu
ey	ey
eĩ	ei
eũ	eu
eɿ	eɿ
f	f
g	g
h	h
i	i
i$	i
i*/au	y/ɥ */au
i*/e	y/ɥ */e
i*/o	y/ɥ */o
i*/ɔ	y/ɥ */ɔ
i*/ə	y/ɥ */ə
ia	i/j a
iai	i/j ai
iau	i/j au
iay	i/j ay
iaĩ	i/j ai
iaũ	i/j au
ie	i/j e
iei	i/j ei
ieu	i/j eu
iey	i/j ey
ieĩ	i/j ei
ieũ	i/j eu
ii	i/j i
iii	i/j i
iiu	i/j iu
iiy	i/j iy
iiĩ	i/j i
iiũ	i/j iu
io	i/j o
io*/u	i/j */ou
ioi	i/j oi
iou	i/j ou
ioy	i/j oy
ioĩ	i/j oi
ioũ	i/j ou
iu	i/j u
iui	i/j ui
iuu	i/j uu
iuy	i/j uy
iuĩ	i/j ui
iuũ	i/j uu
iy	i/j y
iã	i/j ã
iãi	i/j ãi
iãu	i/j ãu
iãy	i/j ãy
iãĩ	i/j ãi
iãũ	i/j ãu
iæ	i/j æ
iæ̃	j æ̃
iø	i/j ø
iĩ	iĩ/ĩ
iœ	i/j œ
iœi	i/j œi
iœu	i/j œu
iœy	i/j œy
iœĩ	i/j œi
iœũ	i/j œu
iũ	i/j ũ
iũi	i/j ũi
iũu	i/j ũu
iũy	i/j ũy
iũĩ	i/j ũi
iũũ	i/j ũu
iɐ	i/j ɐ
iɐi	i/j ɐi
iɐu	i/j ɐu
iɐy	i/j ɐy
iɐĩ	i/j ɐi
iɐũ	i/j ɐu
iɑ	i/j ɑ
iɑ*/u	i/j */ɑu
iɑi	i/j ɑi
iɑo	i/j ɑo
iɑu	i/j ɑu
iɑy	i/j ɑy
iɑĩ	i/j ɑi
iɑŋʔ	i/j ɑ ŋʔ/ŋ
iɑũ	i/j ɑu
iɑ̃	i/j ɑ̃
iɑ̃i	i/j ɑ̃i
iɑ̃u	i/j ɑ̃u
iɑ̃y	i/j ɑ̃y
iɑ̃ĩ	i/j ɑ̃i
iɑ̃ũ	i/j ɑ̃u
iɒ	i/j ɒ
iɒi	i/j ɒi
iɒu	i/j ɒu
iɒy	i/j ɒy
iɒĩ	i/j ɒi
iɒũ	i/j ɒu
iɔ	i/j ɔ
iɔi	i/j ɔi
iɔu	i/j ɔu
iɔy	i/j ɔy
iɔĩ	i/j ɔi
iɔũ	i/j ɔu
iɔ̃	i/j ɔ̃
iɔ̃i	i/j ɔ̃i
iɔ̃u	i/j ɔ̃u
iɔ̃y	i/j ɔ̃y
iɔ̃ĩ	i/j ɔ̃i
iɔ̃ũ	i/j ɔ̃u
iə	i/j ə
iəi	i/j əi
iəu	i/j əu
iəy	i/j əy
iəĩ	i/j əi
iəũ	i/j əu
iə̃	i/j ə̃
iə̃i	i/j ə̃i
iə̃u	i/j ə̃u
iə̃y	i/j ə̃y
iə̃ĩ	i/j ə̃i
iə̃ũ	i/j ə̃u
iɛ	i/j ɛ
iɛa	i/j ɛa
iɛi	i/j ɛi
iɛu	i/j ɛu
iɛy	i/j ɛy
iɛĩ	i/j ɛi
iɛũ	i/j ɛu
iɛ̃	i/j ɛ̃
iɛ̃i	i/j ɛ̃i
iɛ̃u	i/j ɛ̃u
iɛ̃y	i/j ɛ̃y
iɛ̃ĩ	i/j ɛ̃i
iɛ̃ũ	i/j ɛ̃u
iɜ	i/j ɜ
iɜi	i/j ɜi
iɜu	i/j ɜu
iɜy	i/j ɜy
iɜĩ	i/j ɜi
iɜũ	i/j ɜu
iɤ	i/j ɤ
iɤi	i/j ɤi
iɤu	i/j ɤu
iɤy	i/j ɤy
aɤ	aɤ
i*/æ̃	i/j */æ̃
y*/æ̃	y/ɥ */æ̃
u*/ɑ	u/w */ɑ
u*ã	u/w */ã
iɤĩ	i/j ɤi
iɤũ	i/j ɤu
iɤɯ	i/j ɤɯ
iɪ	iɪ
iɯ	i/j ɯ
iʊ	i/j ʊ
iʊi	i/j ʊi
iʊu	i/j ʊu
iʊy	i/j ʊy
iʊĩ	i/j ʊi
iʊũ	i/j ʊu
iʊ̃	i/j ʊ̃
iʊ̃i	i/j ʊ̃i
iʊ̃u	i/j ʊ̃u
iʊ̃y	i/j ʊ̃y
iʊ̃ĩ	i/j ʊ̃i
iʊ̃ũ	i/j ʊ̃u
iʏ	i/j ʏ
iʏi	i/j ʏi
iʏu	i/j ʏu
iʏy	i/j ʏy
iʏĩ	i/j ʏi
iʏũ	i/j ʏu
iᴇ	y/ɥ ᴇ/ɛ
iẽ	i/j ẽ
iẽi	i/j ẽi
iẽu	i/j ẽu
iẽy	i/j ẽy
iẽĩ	i/j ẽi
iẽũ	i/j ẽu
j	i/j
j ɑo	i/j ɑo
j ɑŋ	i/j ɑŋ
j ɤɯ	i/j ɤɯ
jɤɯ	i/j ɤɯ
k	k
kʰ	kʰ
l	l
m	m
m̩	m̩
n	n
n$	n
n̩	n̩
o	o
o*/u	*/ou
oe	oe
oi	oi
onʔ	o nʔ/n
ou	ou
oy	oy
oĩ	oi
oũ	ou
õi	õi
õũ	õu
p	p
pf	pf
pfʰ	pfʰ
pʰ	pʰ
r/o	r/o
s	s
t	t
ts	ts
tsʰ	tsʰ
tɕ	tɕ
tɕʰ	tɕʰ
tʂʰ	ʈʂʰ
tʃ	tʃ
tʃʰ	tʃʰ
tʰ	tʰ
tʰh	tʰ
tʰutn	tʰ u t ⁰
t↑	tʰ
u	u
u$	u
u*/a	u/w */a
u*/e	u/w */e
u*/ei	u/w */ei
u*/o	u/w */o
u*/æ̃	u/w */æ̃
u*/ə	u/w */ə
u*/ə̃	u/w */ə̃
ua	u/w a
uae	u/w ae
uai	u/w ai
uau	u/w au
uay	u/w ay
uaĩ	u/w ai
uaũ	u/w au
ue	u/w e
uei	u/w ei
ueu	u/w eu
uey	u/w ey
ueĩ	u/w ei
ueũ	u/w eu
ui	u/w i
uii	u/w ii
uiu	u/w iu
uiy	u/w iy
uiĩ	u/w ii
uiũ	u/w iu
uo	u/w o
uoi	u/w oi
uou	u/w ou
uoy	u/w oy
uoĩ	u/w oi
uoũ	u/w ou
uu	u/w u
uui	u/w ui
uuu	u/w uu
uuy	u/w uy
uuĩ	u/w ui
uuũ	u/w uu
uy	uy
uã	u/w ã
uãi	u/w ãi
uãu	u/w ãu
uãy	u/w ãy
uãĩ	u/w ãi
uãũ	u/w ãu
uæ	u/w æ
uæ̃	u/w æ̃
uĩ	ui
uœ	u/w œ
uœi	u/w œi
uœu	u/w œu
uœy	u/w œy
uœĩ	u/w œi
uœũ	u/w œu
uũ	u/w ũ
uũi	u/w ũi
uũu	u/w ũu
uũy	u/w ũy
uũĩ	u/w ũi
uũũ	u/w ũu
uɐ	u/w ɐ
uɐi	u/w ɐi
uɐu	u/w ɐu
uɐy	u/w ɐy
uɐĩ	u/w ɐi
uɐũ	u/w ɐu
uɑ	u/w ɑ
uɑi	u/w ɑi
uɑu	u/w ɑu
uɑy	u/w ɑy
uɑĩ	u/w ɑi
uɑũ	u/w ɑu
uɑ̃	u/w ɑ̃
uɑ̃i	u/w ɑ̃i
uɑ̃u	u/w ɑ̃u
uɑ̃y	u/w ɑ̃y
uɑ̃ĩ	u/w ɑ̃i
uɑ̃ũ	u/w ɑ̃u
uɒ	u/w ɒ
uɒi	u/w ɒi
uɒu	u/w ɒu
uɒy	u/w ɒy
uɒĩ	u/w ɒi
uɒũ	u/w ɒu
uɔ	u/w ɔ
uɔi	u/w ɔi
uɔu	u/w ɔu
uɔy	u/w ɔy
uɔĩ	u/w ɔi
uɔũ	u/w ɔu
uɔ̃	u/w ɔ̃
uɔ̃i	u/w ɔ̃i
uɔ̃u	u/w ɔ̃u
uɔ̃y	u/w ɔ̃y
uɔ̃ĩ	u/w ɔ̃i
uɔ̃ũ	u/w ɔ̃u
uə	u/w ə
uəi	u/w əi
uəu	u/w əu
uəy	u/w əy
uəĩ	u/w əi
uəũ	u/w əu
uə̃	u/w ə̃
uə̃i	u/w ə̃i
uə̃u	u/w ə̃u
uə̃y	u/w ə̃y
uə̃ĩ	u/w ə̃i
uə̃ũ	u/w ə̃u
uɛ	u/w ɛ
uɛi	u/w ɛi
uɛu	u/w ɛu
uɛy	u/w ɛy
uɛĩ	u/w ɛi
uɛũ	u/w ɛu
uɛ̃	u/w ɛ̃
uɛ̃i	u/w ɛ̃i
uɛ̃u	u/w ɛ̃u
uɛ̃y	u/w ɛ̃y
uɛ̃ĩ	u/w ɛ̃i
uɛ̃ũ	u/w ɛ̃u
uɜ	u/w ɜ
uɜi	u/w ɜi
uɜu	u/w ɜu
uɜy	u/w ɜy
uɜĩ	u/w ɜi
uɜũ	u/w ɜu
uɤ	u/w ɤ
uɤi	u/w ɤi
uɤu	u/w ɤu
uɤy	u/w ɤy
uɤĩ	u/w ɤi
uɤũ	u/w ɤu
uʊ	u/w ʊ
uʊi	u/w ʊi
uʊu	u/w ʊu
uʊy	u/w ʊy
uʊĩ	u/w ʊi
uʊũ	u/w ʊu
uʊ̃	u/w ʊ̃
uʊ̃i	u/w ʊ̃i
uʊ̃u	u/w ʊ̃u
uʊ̃y	u/w ʊ̃y
uʊ̃ĩ	u/w ʊ̃i
uʊ̃ũ	u/w ʊ̃u
uʏ	u/w ʏ
uʏi	u/w ʏi
uʏu	u/w ʏu
uʏy	u/w ʏy
uʏĩ	u/w ʏi
uʏũ	u/w ʏu
uᴇ	u/w ᴇ/ɛ
uᴇ/ɛ	u/w ᴇ/ɛ
uẽ	u/w ẽ
uẽi	u/w ẽi
uẽu	u/w ẽu
uẽy	u/w ẽy
uẽĩ	u/w ẽi
uẽũ	u/w ẽu
v	v
w	w
x	x
y	y
y*/au	y/ɥ */au
y*/e	y/ɥ */e
y*/o	y/ɥ */o
y*/ɔ	y/ɥ */ɔ
y*/ə	y/ɥ */ə
ya	y/ɥ a
yai	y/ɥ ai
yau	y/ɥ au
yay	y/ɥ ay
yaĩ	y/ɥ ai
yaũ	y/ɥ au
ye	y/ɥ e
yei	y/ɥ ei
yeu	y/ɥ eu
yey	y/ɥ ey
yeĩ	y/ɥ ei
yeũ	y/ɥ eu
yi	y/ɥ i
yii	y/ɥ ii
yiu	y/ɥ iu
yiy	y/ɥ iy
yiĩ	y/ɥ ii
yiũ	y/ɥ iu
yo	y/ɥ o
yoi	y/ɥ oi
you	y/ɥ ou
yoy	y/ɥ oy
yoĩ	y/ɥ oi
yoũ	y/ɥ ou
yu	y/ɥ u
yui	y/ɥ ui
yuu	y/ɥ uu
yuy	y/ɥ uy
yuĩ	y/ɥ ui
yuũ	y/ɥ uu
yã	y/ɥ ã
yãi	y/ɥ ãi
yãu	y/ɥ ãu
yãy	y/ɥ ãy
yãĩ	y/ɥ ãi
yãũ	y/ɥ ãu
yæ̃	y/ɥ æ̃
yĩ	y/ɥ ĩ
yœ	y/ɥ œ
yœi	y/ɥ œi
yœu	y/ɥ œu
yœy	y/ɥ œy
yœĩ	y/ɥ œi
yœũ	y/ɥ œu
yũ	y/ɥ ũ
yũi	y/ɥ ũi
yũu	y/ɥ ũu
yũy	y/ɥ ũy
yũĩ	y/ɥ ũi
yũũ	y/ɥ ũu
yɐ	y/ɥ ɐ
yɐi	y/ɥ ɐi
yɐu	y/ɥ ɐu
yɐy	y/ɥ ɐy
yɐĩ	y/ɥ ɐi
yɐũ	y/ɥ ɐu
yɑ	y/ɥ ɑ
yɑi	y/ɥ ɑi
yɑu	y/ɥ ɑu
yɑy	y/ɥ ɑy
yɑĩ	y/ɥ ɑi
yɑũ	y/ɥ ɑu
yɑ̃	y/ɥ ɑ̃
yɑ̃i	y/ɥ ɑ̃i
yɑ̃u	y/ɥ ɑ̃u
yɑ̃y	y/ɥ ɑ̃y
yɑ̃ĩ	y/ɥ ɑ̃i
yɑ̃ũ	y/ɥ ɑ̃u
yɒ	y/ɥ ɒ
yɒi	y/ɥ ɒi
yɒu	y/ɥ ɒu
yɒy	y/ɥ ɒy
yɒĩ	y/ɥ ɒi
yɒũ	y/ɥ ɒu
yɔ	y/ɥ ɔ
yɔi	y/ɥ ɔi
yɔu	y/ɥ ɔu
yɔy	y/ɥ ɔy
yɔĩ	y/ɥ ɔi
yɔũ	y/ɥ ɔu
yɔ̃	y/ɥ ɔ̃
yɔ̃i	y/ɥ ɔ̃i
yɔ̃u	y/ɥ ɔ̃u
yɔ̃y	y/ɥ ɔ̃y
yɔ̃ĩ	y/ɥ ɔ̃i
yɔ̃ũ	y/ɥ ɔ̃u
yə	y/ɥ ə
yəi	y/ɥ əi
yəu	y/ɥ əu
yəy	y/ɥ əy
yəĩ	y/ɥ əi
yəũ	y/ɥ əu
yə̃	y/ɥ ə̃
yə̃i	y/ɥ ə̃i
yə̃u	y/ɥ ə̃u
yə̃y	y/ɥ ə̃y
yə̃ĩ	y/ɥ ə̃i
yə̃ũ	y/ɥ ə̃u
yɛ	y/ɥ ɛ
yɛi	y/ɥ ɛi
yɛu	y/ɥ ɛu
yɛy	y/ɥ ɛy
yɛĩ	y/ɥ ɛi
yɛũ	y/ɥ ɛu
yɛ̃	y/ɥ ɛ̃
yɛ̃i	y/ɥ ɛ̃i
yɛ̃u	y/ɥ ɛ̃u
yɛ̃y	y/ɥ ɛ̃y
yɛ̃ĩ	y/ɥ ɛ̃i
yɛ̃ũ	y/ɥ ɛ̃u
yɜ	y/ɥ ɜ
yɜi	y/ɥ ɜi
yɜu	y/ɥ ɜu
yɜy	y/ɥ ɜy
yɜĩ	y/ɥ ɜi
yɜũ	y/ɥ ɜu
yɤ	y/ɥ ɤ
yɤi	y/ɥ ɤi
yɤu	y/ɥ ɤu
yɤy	y/ɥ ɤy
yɤĩ	y/ɥ ɤi
yɤũ	y/ɥ ɤu
yʊ	y/ɥ ʊ
yʊi	y/ɥ ʊi
yʊu	y/ɥ ʊu
yʊy	y/ɥ ʊy
yʊĩ	y/ɥ ʊi
yʊũ	y/ɥ ʊu
yʊ̃	y/ɥ ʊ̃
yʊ̃i	y/ɥ ʊ̃i
yʊ̃u	y/ɥ ʊ̃u
yʊ̃y	y/ɥ ʊ̃y
yʊ̃ĩ	y/ɥ ʊ̃i
yʊ̃ũ	y/ɥ ʊ̃u
yʏ	y/ɥ ʏ
yʏi	y/ɥ ʏi
yʏu	y/ɥ ʏu
yʏy	y/ɥ ʏy
yʏĩ	y/ɥ ʏi
yʏũ	y/ɥ ʏu
yᴇ	y/ɥ ᴇ/ɛ
yẽ	y/ɥ ẽ
yẽi	y/ɥ ẽi
yẽu	y/ɥ ẽu
yẽy	y/ɥ ẽy
yẽĩ	y/ɥ ẽi
yẽũ	y/ɥ ẽu
z	z
²	²
²$	²
²²	²²
²²$	²²
²²/²⁴	²²/²⁴
²²/³¹	²²/³¹
²³	²³
²³$	²³
²³/³³	²³/³³
²³/⁴	²³/⁴
²³/⁵⁵	²³/⁵⁵
²¹	²¹
²¹$	²¹
²¹/²³	²¹/²³
²¹/²¹³	²¹/²¹³
²¹/²¹⁴	²¹/²¹⁴
²¹/²⁴	²¹/²⁴
²¹/³³	²¹/³³
²¹/³¹	²¹/³¹
²¹/³⁵	²¹/³⁵
²¹/⁴	²¹/⁴
²¹/⁴¹	²¹/⁴¹
²¹/⁴⁴	²¹/⁴⁴
²¹/⁴⁵	²¹/⁴⁵
²¹/⁵³	²¹/⁵³
²¹/⁵¹³	²¹/⁵¹³
²¹/⁵⁵	²¹/⁵⁵
²¹²	²¹²
²¹²$	²¹²
²¹³	²¹³
²¹³$	²¹³
²¹³/⁵³	²¹³/⁵³
²¹³/⁵⁵	²¹³/⁵⁵
²¹⁰/²¹⁴	²¹⁰/²¹⁴
²¹⁴$	²¹⁴
²⁴	²⁴
²⁴$	²⁴
²⁴/²¹	²⁴/²¹
²⁴/²¹³	²⁴/²¹³
²⁴/³¹	²⁴/³¹
²⁴/³⁵	²⁴/³⁵
²⁴/⁵³	²⁴/⁵³
²⁴²$	²⁴²
²⁴²/⁴⁴	²⁴²/⁴⁴
³/²¹	³/²¹
³²	³²
³²$	³²
³²/⁵	³²/⁵
³³	³³
³³$	³³
³³/²³	³³/²³
³³/²⁴	³³/²⁴
³³/³¹	³³/³¹
³³/⁴¹	³³/⁴¹
³³/⁵⁵	³³/⁵⁵
³¹	³¹
³¹$	³¹
³¹/²³	³¹/²³
³¹/²¹³	³¹/²¹³
³¹/²⁴²	³¹/²⁴²
³¹/¹³	³¹/¹³
³¹/¹¹	³¹/¹¹
³¹/⁴	³¹/⁴
³¹/⁴⁴	³¹/⁴⁴
³¹/⁵²	³¹/⁵²
³¹/⁵³	³¹/⁵³
³⁴	³⁴
³⁴$	³⁴
³⁴/⁴²	³⁴/⁴²
³⁴/⁵⁵	³⁴/⁵⁵
³⁵	³⁵
³⁵$	³⁵
³⁵/²²	³⁵/²²
³⁵/²³	³⁵/²³
³⁵/²¹	³⁵/²¹
³⁵/²¹³	³⁵/²¹³
³⁵/²¹⁴	³⁵/²¹⁴
³⁵/³³	³⁵/³³
³⁵/⁴¹	³⁵/⁴¹
³⁵/⁴⁴	³⁵/⁴⁴
³⁵/⁵¹³	³⁵/⁵¹³
¹	¹
¹²	¹²
¹²$	¹²
¹²/¹¹	¹²/¹¹
¹³	¹³
¹³$	¹³
¹³/³¹	¹³/³¹
¹³/⁴⁴	¹³/⁴⁴
¹¹	¹¹
¹¹$	¹¹
¹¹/²⁴	¹¹/²⁴
¹¹/³³	¹¹/³³
¹¹/⁵¹	¹¹/⁵¹
¹¹/⁵⁵	¹¹/⁵⁵
ã	ã
ãi	ãi
ãu	ãu
ãy	ãy
ãĩ	ãi
ãũ	ãu
æ	æ
æ̃	æ̃
õ	õ
õĩ	õi
ø	ø
øy	øi
ĩ	ĩ
ĩa	j a
ĩai	j ai
ĩau	j au
ĩay	j ay
ĩaĩ	j ai
ĩaũ	j au
ĩe	j e
ĩei	j ei
ĩeu	j eu
ĩey	j ey
ĩeĩ	j ei
ĩeũ	j eu
ĩi	j i
ĩii	j ii
ĩiu	j iu
ĩiy	j iy
ĩiĩ	j ii
ĩiũ	j iu
ĩo	j o
ĩoi	j oi
ĩou	j ou
ĩoy	j oy
ĩoĩ	j oi
ĩoũ	j ou
ĩu	j u
ĩui	j ui
ĩuu	j uu
ĩuy	j uy
ĩuĩ	j ui
ĩuũ	j uu
ĩã	j ã
ĩãi	j ãi
ĩãu	j ãu
ĩãy	j ãy
ĩãĩ	j ãi
ĩãũ	j ãu
ĩœ	j œ
ĩœi	j œi
ĩœu	j œu
ĩœy	j œy
ĩœĩ	j œi
ĩœũ	j œu
ĩũ	j ũ
ĩũi	j ũi
ĩũu	j ũu
ĩũy	j ũy
ĩũĩ	j ũi
ĩũũ	j ũu
ĩɐ	j ɐ
ĩɐi	j ɐi
ĩɐu	j ɐu
ĩɐy	j ɐy
ĩɐĩ	j ɐi
ĩɐũ	j ɐu
ĩɑ	j ɑ
ĩɑi	j ɑi
ĩɑu	j ɑu
ĩɑy	j ɑy
ĩɑĩ	j ɑi
ĩɑũ	j ɑu
ĩɑ̃	j ɑ̃
ĩɑ̃i	j ɑ̃i
ĩɑ̃u	j ɑ̃u
ĩɑ̃y	j ɑ̃y
ĩɑ̃ĩ	j ɑ̃i
ĩɑ̃ũ	j ɑ̃u
ĩɒ	j ɒ
ĩɒi	j ɒi
ĩɒu	j ɒu
ĩɒy	j ɒy
ĩɒĩ	j ɒi
ĩɒũ	j ɒu
ĩɔ	j ɔ
ĩɔi	j ɔi
ĩɔu	j ɔu
ĩɔy	j ɔy
ĩɔĩ	j ɔi
ĩɔũ	j ɔu
ĩɔ̃	j ɔ̃
ĩɔ̃i	j ɔ̃i
ĩɔ̃u	j ɔ̃u
ĩɔ̃y	j ɔ̃y
ĩɔ̃ĩ	j ɔ̃i
ĩɔ̃ũ	j ɔ̃u
ĩə	j ə
ĩəi	j əi
ĩəu	j əu
ĩəy	j əy
ĩəĩ	j əi
ĩəũ	j əu
ĩə̃	j ə̃
ĩə̃i	j ə̃i
ĩə̃u	j ə̃u
ĩə̃y	j ə̃y
ĩə̃ĩ	j ə̃i
ĩə̃ũ	j ə̃u
ĩɛ	j ɛ
ĩɛi	j ɛi
ĩɛu	j ɛu
ĩɛy	j ɛy
ĩɛĩ	j ɛi
ĩɛũ	j ɛu
ĩɛ̃	j ɛ̃
ĩɛ̃i	j ɛ̃i
ĩɛ̃u	j ɛ̃u
ĩɛ̃y	j ɛ̃y
ĩɛ̃ĩ	j ɛ̃i
ĩɛ̃ũ	j ɛ̃u
ĩɜ	j ɜ
ĩɜi	j ɜi
ĩɜu	j ɜu
ĩɜy	j ɜy
ĩɜĩ	j ɜi
ĩɜũ	j ɜu
ĩɤ	j ɤ
ĩɤi	j ɤi
ĩɤu	j ɤu
ĩɤy	j ɤy
ĩɤĩ	j ɤi
ĩɤũ	j ɤu
ĩʊ	j ʊ
ĩʊi	j ʊi
ĩʊu	j ʊu
ĩʊy	j ʊy
ĩʊĩ	j ʊi
ĩʊũ	j ʊu
ĩʊ̃	j ʊ̃
ĩʊ̃i	j ʊ̃i
ĩʊ̃u	j ʊ̃u
ĩʊ̃y	j ʊ̃y
ĩʊ̃ĩ	j ʊ̃i
ĩʊ̃ũ	j ʊ̃u
ĩʏ	j ʏ
ĩʏi	j ʏi
ĩʏu	j ʏu
ĩʏy	j ʏy
ĩʏĩ	j ʏi
ĩʏũ	j ʏu
ĩẽ	j ẽ
ĩẽi	j ẽi
ĩẽu	j ẽu
ĩẽy	j ẽy
ĩẽĩ	j ẽi
ĩẽũ	j ẽu
ŋ	ŋ
ŋ̍	ŋ̍
aŋ̍	a ŋ̍/ŋ
œ	œ
œi	œi
œu	œu
œy	œy
œĩ	œi
œũ	œu
ũ	ũ
ũa	w a
ũai	w ai
ũau	w au
ũay	w ay
ũaĩ	w ai
ũaũ	w au
ũe	w e
ũei	w ei
ũeu	w eu
ũey	w ey
ũeĩ	w ei
ũeũ	w eu
ũi	w i
ũii	w ii
ũiu	w iu
ũiy	w iy
ũiĩ	w ii
ũiũ	w iu
ũo	w o
ũoi	w oi
ũou	w ou
ũoy	w oy
ũoĩ	w oi
ũoũ	w ou
ũu	w u
ũui	w ui
ũuu	w uu
ũuy	w uy
ũuĩ	w ui
ũuũ	w uu
ũy	ũy
ũã	w ã
ũãi	w ãi
ũãu	w ãu
ũãy	w ãy
ũãĩ	w ãi
ũãũ	w ãu
ũĩ	ũi
ũœ	w œ
ũœi	w œi
ũœu	w œu
ũœy	w œy
ũœĩ	w œi
ũœũ	w œu
ũũ	w ũ
ũũi	w ũi
ũũu	w ũu
ũũy	w ũy
ũũĩ	w ũi
ũũũ	w ũu
ũɐ	w ɐ
ũɐi	w ɐi
ũɐu	w ɐu
ũɐy	w ɐy
ũɐĩ	w ɐi
ũɐũ	w ɐu
ũɑ	w ɑ
ũɑi	w ɑi
ũɑu	w ɑu
ũɑy	w ɑy
ũɑĩ	w ɑi
ũɑũ	w ɑu
ũɑ̃	w ɑ̃
ũɑ̃i	w ɑ̃i
ũɑ̃u	w ɑ̃u
ũɑ̃y	w ɑ̃y
ũɑ̃ĩ	w ɑ̃i
ũɑ̃ũ	w ɑ̃u
ũɒ	w ɒ
ũɒi	w ɒi
ũɒu	w ɒu
ũɒy	w ɒy
ũɒĩ	w ɒi
ũɒũ	w ɒu
ũɔ	w ɔ
ũɔi	w ɔi
ũɔu	w ɔu
ũɔy	w ɔy
ũɔĩ	w ɔi
ũɔũ	w ɔu
ũɔ̃	w ɔ̃
ũɔ̃i	w ɔ̃i
ũɔ̃u	w ɔ̃u
ũɔ̃y	w ɔ̃y
ũɔ̃ĩ	w ɔ̃i
ũɔ̃ũ	w ɔ̃u
ũə	w ə
ũəi	w əi
ũəu	w əu
ũəy	w əy
ũəĩ	w əi
ũəũ	w əu
ũə̃	w ə̃
ũə̃i	w ə̃i
ũə̃u	w ə̃u
ũə̃y	w ə̃y
ũə̃ĩ	w ə̃i
ũə̃ũ	w ə̃u
ũɛ	w ɛ
ũɛi	w ɛi
ũɛu	w ɛu
ũɛy	w ɛy
ũɛĩ	w ɛi
ũɛũ	w ɛu
ũɛ̃	w ɛ̃
ũɛ̃i	w ɛ̃i
ũɛ̃u	w ɛ̃u
ũɛ̃y	w ɛ̃y
ũɛ̃ĩ	w ɛ̃i
ũɛ̃ũ	w ɛ̃u
ũɜ	w ɜ
ũɜi	w ɜi
ũɜu	w ɜu
ũɜy	w ɜy
ũɜĩ	w ɜi
ũɜũ	w ɜu
ũɤ	w ɤ
ũɤi	w ɤi
ũɤu	w ɤu
ũɤy	w ɤy
ũɤĩ	w ɤi
ũɤũ	w ɤu
ũʊ	w ʊ
ũʊi	w ʊi
ũʊu	w ʊu
ũʊy	w ʊy
ũʊĩ	w ʊi
ũʊũ	w ʊu
ũʊ̃	w ʊ̃
ũʊ̃i	w ʊ̃i
ũʊ̃u	w ʊ̃u
ũʊ̃y	w ʊ̃y
ũʊ̃ĩ	w ʊ̃i
ũʊ̃ũ	w ʊ̃u
ũʏ	w ʏ
ũʏi	w ʏi
ũʏu	w ʏu
ũʏy	w ʏy
ũʏĩ	w ʏi
ũʏũ	w ʏu
ũẽ	w ẽ
ũẽi	w ẽi
ũẽu	w ẽu
ũẽy	w ẽy
ũẽĩ	w ẽi
ũẽũ	w ẽu
ȵ	ȵ
ɐ	ɐ
ɐi	ɐi
ɐu	ɐu
ɐui	ɐui/ɐi
ɐy	ɐy
ɐĩ	ɐi
ɐũ	ɐu
ɑ	ɑ
ɑ*/u	*/ɑu
ɑi	ɑi
ɑo	ɑo
ɑu	ɑu
ɑy	ɑy
ɑĩ	ɑi
ɑŋʔ	ɑ ŋʔ/ŋ
ɑũ	ɑu
ɑɑ	ɑː
ɑɤ	ɑɤ
ɑ̃	ɑ̃
ɑ̃i	ɑ̃i
ɑ̃u	ɑ̃u
ɑ̃y	ɑ̃y
ɑ̃ĩ	ɑ̃i
ɑ̃ũ	ɑ̃u
ɒ	ɒ
ɒi	ɒi
ɒu	ɒu
ɒy	ɒy
ɒĩ	ɒi
ɒũ	ɒu
ɔ	ɔ
ɔi	ɔi
ɔu	ɔu
ɔy	ɔy
ɔĩ	ɔi
ɔũ	ɔu
ɔ̃	ɔ̃
ɔ̃i	ɔ̃i
ɔ̃u	ɔ̃u
ɔ̃y	ɔ̃y
ɔ̃ĩ	ɔ̃i
ɔ̃ũ	ɔ̃u
ɕ	ɕ
ə	ə
ə$	ə
ə*/u	*/əu
əi	əi
əu	əu
əy	əy
əĩ	əi
əũ	əu
ə̃	ə̃
ə̃i	ə̃i
ə̃u	ə̃u
ə̃y	ə̃y
ə̃ĩ	ə̃i
ə̃ũ	ə̃u
ɚ/ə	ɚ/ə
ɛ	ɛ
ɛ$	ɛ
ɛi	ɛi
ɛu	ɛu
ɛy	ɛy
ɛĩ	ɛi
ɛũ	ɛu
ɛ̃	ɛ̃
ɛ̃i	ɛ̃i
ɛ̃u	ɛ̃u
ɛ̃y	ɛ̃y
ɛ̃ĩ	ɛ̃i
ɛ̃ũ	ɛ̃u
ɜ	ɜ
ɜi	ɜi
ɜu	ɜu
ɜy	ɜy
ɜĩ	ɜi
ɜũ	ɜu
ɤ	ɤ
ɤi	ɤi
ɤu	ɤu
ɤy	ɤy
ɤĩ	ɤi
ɤũ	ɤu
ɤɯ	ɤɯ
ɦ	ɦ
ɪ	ɪ
ɪɪ̃	ɪ/j ɪ̃
ɬ	ɬ
ɯ	ɯ
ɵ	ɵ
ɵy	ɵy
ɿ	ɿ
ɿ$	ɿ
ʂ	ʂ
ʃ	ʃ
ʅ	ʅ
ʈʂ	ʈʂ
ʈʂʰ	ʈʂʰ
ʊ	ʊ
ʊi	ʊi
ʊu	ʊu
ʊy	ʊy
ʊĩ	ʊi
ʊũ	ʊu
ʊ̃	ʊ̃
ʊ̃i	ʊ̃i
ʊ̃u	ʊ̃u
ʊ̃y	ʊ̃y
ʊ̃ĩ	ʊ̃i
ʊ̃ũ	ʊ̃u
ʏ	ʏ
ʏi	ʏi
ʏu	ʏu
ʏy	ʏy
ʏĩ	ʏi
ʏũ	ʏu
ʐ	ʐ
ʔ	ʔ
ʮ	ʮ
ʰt	tʰ
ʰtõ⁴¹	tʰ ɔ̃ ⁴¹
β	β
ᴇ	ᴇ/ɛ
ẽ	ẽ
ẽi	ẽi
ẽu	ẽu
ẽy	ẽy
ẽĩ	ẽi
ẽũ	ẽu
⁰	⁰
⁰$	⁰
⁰/⁰	⁰/⁰
⁴	⁴
⁴$	⁴
⁴/²³	⁴/²³
⁴/²¹	⁴/²¹
⁴²	⁴²
⁴²$	⁴²
⁴²/²¹³	⁴²/²¹³
⁴²/⁵⁵	⁴²/⁵⁵
⁴¹	⁴¹
⁴¹$	⁴¹
⁴⁴	⁴⁴
⁴⁴$	⁴⁴
⁴⁴/²¹³	⁴⁴/²¹³
⁴⁴/²⁴²	⁴⁴/²⁴²
⁴⁴/³¹	⁴⁴/³¹
⁴⁴/¹³	⁴⁴/¹³
⁴⁴/⁴¹	⁴⁴/⁴¹
⁴⁴/⁵²	⁴⁴/⁵²
⁴⁴/⁵³	⁴⁴/⁵³
⁴⁴/⁵¹³	⁴⁴/⁵¹³
⁴⁴³	⁴⁴³
⁴⁴³$	⁴⁴³
⁴⁴⁴/⁵¹³	⁴⁴⁴/⁵¹³
⁴⁵	⁴⁵
⁴⁵$	⁴⁵
⁴⁵/²³	⁴⁵/²³
⁴⁵/³¹	⁴⁵/³¹
⁴⁵¹$	⁴⁵¹
⁴⁵⁴	⁴⁵⁴
⁴⁵⁴$	⁴⁵⁴
⁵	⁵
⁵$	⁵
⁵/²¹	⁵/²¹
⁵/³²	⁵/³²
⁵²	⁵²
⁵²$	⁵²
⁵²/²¹³	⁵²/²¹³
⁵²/²⁴²	⁵²/²⁴²
⁵²/³¹	⁵²/³¹
⁵²/⁴⁴	⁵²/⁴⁴
⁵³	⁵³
⁵³$	⁵³
⁵³/²¹³	⁵³/²¹³
⁵³/¹³	⁵³/¹³
⁵¹	⁵¹
⁵¹$	⁵¹
⁵¹/¹¹	⁵¹/¹¹
⁵¹³	⁵¹³
⁵¹³$	⁵¹³
⁵⁵	⁵⁵
⁵⁵$	⁵⁵
⁵⁵/²¹	⁵⁵/²¹
⁵⁵/²¹²	⁵⁵/²¹²
⁵⁵/²¹⁴	⁵⁵/²¹⁴
⁵⁵/³³	⁵⁵/³³
⁵⁵/³⁴	⁵⁵/³⁴
⁵⁵/⁴²	⁵⁵/⁴²
⁵⁵/⁵¹	⁵⁵/⁵¹
∼	NULL
∼$	NULL
